007000000060000000000000000000
002000000020000000000000000000
000020000000020000020000000000
000000200020000020000020000000
000000000000000000000000000a00
444444444444444400000200000000
000000000000009100000000000000
000000222222222100002000002200
220000000055555100000000000000
000200000000000122000000200600
220000000000600100000200000200
000004000002200100000000000000
002221000000000144444444444444
00000000020000e100000000000001
222222200122222100000000022222
000000000100000000000220000000
000022222100055555100000000008
0070000003000000061000440000e1