00e000000e00000e00155511155555
ccccccccccccccccccc00000000000
000000000000000000c00002222200
000222222222007000c00021000000
200000000000002000122210002222
000000000000000000100000001000
22200000000000a000100002221008
000000222200002000102000001002
000000000000021200100000000021
222222222222211122144444222211
600000000000000000000000000000
000000000000000000000022222000
0005551000020000000e0055000022
000000100001222222240000000000
442220100201000000010000022222
000010100001009000010000000000
0b0010144441002000010222200000
222030000000021200010000000222