010000000000000555555555000010
010000222222000000000000000010
012220000001000000000000020010
011112000001000000000007010010
010001200001000000e22222210010
010000120001224422210000000010
016000012000000000000000000010
012000001222200000000000000010
010022000000124242420300200010
010000000000000000000000000210
012000022000000000000000000030
010020001222002222220000222210
010000000000000000000000000110
012000000000000000020000e2001a
911200002222220000012222210010
011120005511112000000000000000
811112000000001200000222200000
2111112000000e7122220000000000