000000000111111000551110000000
000000000c00901000005510a00080
222000222122221000000055551111
000000000000000000000000005511
002222200000000000000000000051
000000000000000000000000000005
222000222000000000000000000000
000000000000000002220000000000
000200002000e20001000000000000
200000001222210001002222000000
000000000000000221000000000000
000200000000022100000444444444
000000000042000360000000000000
222200000000000122200000000000
0000000000000000000027000200b0
000222002222000220001220012220
000000000000000000000000000000
444444444444444444444444444444