000000000000000000000000000000
000000000000000000000000000008
000224242420000000000000000022
200000000000022222220000022211
000000000000000000112220010000
000220000000000000000000000000
200000000000000222222220000000
000000e00000000000000000000000
222222222222220000000000022200
000000000000000000002220000000
0000000000000000000000004000e4
000200000000000022200000122221
000100002220000000000000000000
760300001112222222222002222000
222100000000000000000000000002
000000000222000000000000022241
000000000000000000000e22211111
008222222444222222222211111111