000000000000000000000000001000
000000000000000000000000000001
000000000000000000000000001000
000000000000000000000011000001
000000000001000001111122111100
000000000002000000000000002001
000000000002111111111100002100
000000000000222000000000002001
000000000000002110011111102100
000000000000000020000000002001
000000000000000020000111002100
000000000000000021111222002001
000000000000000000000002002100
000000000000000000000002002001
000000000000000000000000002100
111111111111111111111111112001
000000000000000000000000002100
000000000000000000000000000001