000000000000000000000000000100
000000000000000000000000000001
000000000000000000000000000100
000000000000000000000011000001
000000000000000001111111111100
000000000000000000000000000001
000000000000000000000000000100
000000000000000000000000000001
000000000000000000000000000100
000000000000000000000000000001
000000000000000000000000000100
000000000000000000000000000001
000000000000000000000000000100
000000000000000000000000000001
000000000000000000000000000100
000000000000000000000000000001
000000000000000000000000000100
000000000000000000000000000001